F 0,255,0
C 255,255,0

NO ./textures/basalt_top.xpm
SO ./textures/wet_sponge.xpm
WE ./textures/mossy.xpm
EA ./textures/grey_stone.xpm

1111111111111111111
1000011001001001001
1000000   01001010001    
1000001001001001001
1000001001001001001
100S000011100000001
1000011111111000001
1111001001100001111
1000000101010000001
1111111111111111111
