F 0,0,0
C 255,255,255

NO ./textures/bookshelf.xpm
SO ./textures/bookshelf_01.xpm
WE ./textures/bookshelf_02.xpm
EA ./textures/bookshelf_03.xpm

1111111111111111111111
1111000000000000000001       
1000000000000000001111   
1000000000000000001
1000000000000000001
10000S0000000000001     
1000000000000000001
1000000000000000001
1111111111111111111
