F 0,0,0
C 255,255,255

NO ./textures/bookshelf.xpm
SO ./textures/bookshelf_01.xpm
WE ./textures/bookshelf_02.xpm
EA ./textures/bookshelf_03.xpm

111111111111111111111
111100001100100100101       
110000100100100100101           
100S0010010010010011
1000000011100000001
1000011111111000001
1111001001100001111
1000000101010000001
1111111111111111111
