F 20,255,20
C 205,133,63

NO ./textures/mx.xpm
SO ./textures/bookshelf.xpm
WE ./textures/bookshelf.xpm
EA ./textures/bookshelf.xpm

1111111111111111111
1000011001001001001
10S0011001001001001
1000001001001001001
1000001001001001001
1000000011100000001
1000011111111000001
1111001001100001111
1000000101010000001
1111111111111111111