F 20,255,20
C 205,133,63

NO ./textures/bluestone.xpm
SO ./textures/bluestone.xpm
WE ./textures/bluestone.xpm
EA ./textures/bluestone.xpm

1111111111
1000000001
1000000001
1010000001                   
101E000001
1010000001                        
1000000001                       
1000000001
1000000001
1111111111                  